wwwwwwwwwwwwwww
w     w   w   w
w www www www w
w             w
w           www
w             w
wwww      w   w
wwwwwwwwwwwww w
w             w
w             w
wwwwwwwwwwwwwww
