wwwwwwwwwwwwwww
w             w
wwwwwwww wwwwww
w      w  w   w
w wwww ww   w w
w ww   wwwwww w
w wwwwwww   w w
w       w     w
wwwwwww www www
w     w   w   w
w www www www w
w             w
w           www
w             w
wwww      w   w
wwwwwwwwwwwww w
w             w
w             w
wwwwwwwwwwwwwww
